      F 20,23,232               
      SO ./southpic.png

NO                              ./northpic.png
     C 13,12,122
         WE   ./westpic.png
EA ./eastpic/back/eastpic.png


111111111111
111110001111
100000000001
1100000000011
 10100E0000011
11000010000111
11111111111101
11111111111111

