NO ./path_n.png

SO ./path_s.png

WE ./path_w.png

EA ./path_e.png

F 220,100,0
C 225,30,0

        11111111111111111111111111
        10000000001100000000000001
        10110000011100000000000001
        10010000000000000000000001
1111111110110000011100000000000001
1000000000110000011100011111111111
11110111111110011100000010001
11110111111110011101010010001
11000000110100011100000010001
10000000000000000000000010001
100000000000000011010100S0001
11000001110101011111011001111111
11110111 1110101 101111010001
11111111111111111111111111111
