      F 0,255,0  
      SO ./southpic.png

NO                              ./northpic.png
     C 0,0,255
         WE   ./westpic.png
EA ./eastpic/back/eastpic.png


11111111111111111
1111000111100011
100000001111001111
110001110N01000111
110101110000111111
110001110001111111
1111111111110111111111111
           11111111111111

