      F 0,255,0  
      SO ./southpic.png

NO                              ./northpic.png
     C 0,0,255
         WE   ./westpic.png
EA ./eastpic/back/eastpic.png


111111111111111111111111111
100000000000000000000000001
100000000000000000000000001
100000000000000000000000001
100000000000000000000000001
100000000000000000000000001
100000000000010000000000001
100000000000000000000000001
100000000000000000000000001
100000000000000000000000001
1000000001000N0001000000001
100000000000000000000000001
100000000000000000000000001
100000000000000000000000001
100000000000010000000000001
100000000000000000000000001
100000000000000000000000001
100000000000000000000000001
100000000000000000000000001
100000000000000000000000001
111111111111111111111111111